BMSConfig	KEYWORD1
BMSData	KEYWORD1
BMSCommands	KEYWORD1
ProtectionFlags	KEYWORD1
StatusFlags	KEYWORD1
bmsUpdateConfig	KEYWORD2
bmsSendRecive	KEYWORD2
bmsSendMessage	KEYWORD2
bmsReceiveAnswer	KEYWORD2
bmsCorrectionCycle	KEYWORD2

SUCCESS	LITERAL1
ERROR_TIMEOUT	LITERAL1
ERROR_UNKNOWN	LITERAL1
ERROR_CONNECT	LITERAL1
ERROR_POINTER	LITERAL1
ERROR_DATA	LITERAL1
ERROR_COMMAND	LITERAL1
ERROR_CORRECTION	LITERAL1
ERROR_LIMIT_CYCLES	LITERAL1
ERROR_WAIT	LITERAL1

lowCapacity	LITERAL2
mosfetOverheat	LITERAL2
chargeOvervoltage	LITERAL2
dischargeUndervoltage	LITERAL2
batteryOverheat	LITERAL2
chargeOvercurrent	LITERAL2
dischargeOvercurrent	LITERAL2
cellVoltageImbalance	LITERAL2
batteryCompartmentOverheat	LITERAL2
lowBatteryTemperature	LITERAL2
cellOvervoltage	LITERAL2
cellUndervoltage	LITERAL2
protection309A	LITERAL2
protection309B	LITERAL2
